111111111111111111111111111111111111111
1            2   3 2          1      11
1            2     2          1      11
1            2     2          1      11
1            2222222          1      11
1                             1      11
1                             1      11
1                             1      11
1                             1      11
1                             1      11
1                             1      11
1                             1      11
1                             1      11
12222    2222     2222    22221      11
12222    2222     2222    22221      11
12222    2222     2222    22221      11
12222    2222     2222    22221      11
1                             1      11
1                             1      11
1                             1      11
1                             1      11
1                             1      11
1                             1      11
1            2222222          1      11
1            2     2          1      11
1            2     2          1      11
1            2     2          1      11
111111111111111111111111111111111111111
1              22                     1
1              22                     1
1              22                     1
1   1111111111112                     1
1                                     1
1                                     1
1                                     1
1             111111                  1
1             1                       1
1             1  4                    1
1             1                       1
111111111111111111111111111111111111111